##MMMMMMMMMMMM##
#MM------Z---MMM
#M------------MM
#---FFFFFFF----#
#---F----------#
#---FF----FFF--#
#---FFFMM------#
#----MM##MM----#
#----M####M----#
#-------FFF----#
#-FFF----FF----#
#------Y--F----#
#---FFFFFFF----#
#M------------M#
#MM----------MM#
#MMMMMMMMMMMMM##