##MMMMMMMMMMMM##
#MM----------MMM
#M------------MM
#---FFFFFFF----#
#---F----------#
#---FF----FFF--#
#---FFFMM------#
#----MM##MM----#
#----M####M----#
#-------FFF----#
#-FFF----FF----#
#---------F----#
#---FFFFFFF----#
#M------------M#
#MM----------MM#
#MMMMMMMMMMMMM##