##MMMMMMMMMMMM##
#MMZ---------MMM
#M-----MM-----MM
#---FFFFFFF----#
#---F----------#
#---FF----FFF--#
#---FFFMM------#
##---MM##MM---##
##---M####M---##
#-------FFF----#
#-FFF----FF----#
#---------F----#
#---FFFFFFF----#
#M-----MM-----M#
#MM---------YMM#
#MMMMMMMMMMMMM##